111111111111111111111
300000000000000000003
303111111111111111303
303200000000000002303
303030303030303030303
303030303030303030303
303030000000000030303
303030311101113030303
303030300000003030303
303000303151303000303
303110303r4b303011303
300000003p4y300000003
303110303111303011303
303000300000003000303
303030311101113030303
303030000000000030303
303031113030311130303
303200003000300002303
303111103030301111303
300000000000000000003
111111111111111111111

