111111111111111111111
300000000030000000003
321110111030111011123
300000000000000000003
301110301111103011103
300000302030003000003
303030303030303030303
303030303030303030303
300000000000000000003
301110301151103011103
300000303r4b303000003
301110303p4y303011103
300000001111100000003
303030300000003030303
303030311030113030303
300000300030003000003
301110301111103011103
300000000000000000003
301110111030111011103
320000000030000000023
111111111111111111111