111111111111111111111
300000000000000000003
301110303030303011103
300030303030303032003
303030303030303030303
303200303030303000303
303111300020003111303
300000001111100000003
301110300000003011103
300000303151303000003
301110303r4b303011103
300000303p4y303000003
301110303111303011103
300000000000000000003
303111301111103111323
303002300000003000303
303030301111103030303
300030300000003030003
301130301111103031103
300000000000000000001
111111111111111111111
