111111111111111111111
300000003r4b300000003
301111303p4y303111103
300000303151303000003
301130300000003031103
300030311303113030003
303030000303000030303
303031130303031110303
303000030303030000303
303111030303030111303
300000030303030000003
301111000000000111103
300000030303030000003
301111030303030111103
300000030303030000003
303031030303030330303
303030000000000030303
303030303000303030303
303230323111323032303
300000000000000000003
111111111111111111111